1111111111111111111111111111111111
1EBBBBBBBBBBBBBCBBBBBCBBBBBBBBBBB1
1B1BB1B1BB1BBBBB1B1BB1BBBBBBB1B1B1
1B1BC1BB1B1B1B1BBB1BB1BBBBBBB1B1B1
1BBCPCCBBCBBCBBBBB0BBBBBBBBBBBBBC1
1111111111111111111111111111111111