11111111111111111111111111111111
1E00000000000C00000C000000000001
10000000000000100000000000000001
10000000000000000000000000000001
10000000000000000000000000000101
10B0P00C00C0000000000000000000C1
11111111111111111111111111111111